                                                                                                
###########################                                                                     
#         #               #           ##################################                        
#                         #           #                                #                        
#         #               #############                                #                        
#         #               E                                            #                        
###########               #############                                #                        
          #               #           #                                #   #################### 
          #               #           #                                #   #                  # 
          #######   #######           #                                #   #                  # 
                #   #                 #                                #   #                  # 
   #########    #   #                 #                                #   #                  # 
   #       #    #   #                 #                                #   #                  # 
   #       ######   #                 #                                #   #                  # 
   #                #                 #                                #   #                  # 
   #       ##########   ###########################     ################   #                  # 
   #       #            #            #            #     #                  #                  # 
   ############         #            #            #     #                  #                  # 
    #         #         #            ##############     #                  #######   ########## 
    #         #         #                               #                        #   #          
    #         #         #                               #                        #   #          
    #####  ####         #                               #                        #   #          
        #  #            ######## ########################                        #   #          
        #  #                   # #                   #############################   #          
   ######  ##################### #                   #                               #          
   #                             ############        #                               #          
   #                                        ##########                               #          
   #                                        #                                        #          
   #                                        #                                        #          
   #                                        E                                        #          
   #                                        #                                        #          
   ###################################################################################          