                                                                                                
###########################                                                                     
#         #               #           ##################################                        
#    ~                    #           #                                #                        
#   ~     #               #############                                #                        
# ~~~     #               E                                            #                        
###########               #                                            #                        
          #               #                                            #   #################### 
          #               #                    ~~                      #   #                  # 
          #######   #######                  ~~~                       #   #                  # 
                #   #                      ~~~  ~                      #   #                  # 
   #########    #   #                    ~~~~~~~ ~~                    #   #                  # 
   #       #    #   #                                                  #####                  # 
   #       ######   #                                                  #   #                  # 
   #                #                                                  #   #                  # 
   #       ########################################     ################   #                  # 
   #       #  #                                   #     #                  #                  # 
   ############     ~                             #     #                  #                  # 
    #         #   ~~~~ ############################     #                  ########E########### 
    #         #   ~~~ ~                                 #                            #          
    #         #       ~~~                               #           ~~               #          
    #####  ####         ~~                              #          ~~~               #          
        #  #  ##################E########################          ~~~               #          
        #  #                   # #                   ####          ~~~               #          
   ######  ##################### #                   #             ~~~               #          
   #                             ############        #              ~                #          
   #                                        ##########             ~~~               #          
   #                                        #                     ~ ~~               #          
   #                                        #                    ~ ~~                #          
   #                                        E                                        #          
   #                                        #                                        #          
   ###################################################################################          