                                                                                                
###########################                                                                     
#         #               #           ##################################                        
#    ~                    #           #                                #                        
#   ~     #               #############                                #                        
# ~~~     #               E                                            #                        
###########               #                                            #                        
          #               #                                            #   #################### 
          #               #                                            #   #                  # 
          #######   #######                                            #   #                  # 
                #   #                                                  #   #                  # 
   #########    #   #                    ~~~~~~~                       #   #                  # 
   #       #    #   #                                                  #####                  # 
   #       ######   #                                                  #   #                  # 
   #                #                                                  #   #                  # 
   #       ########################################     ################   #                  # 
   #       #  #                                   #     #                  #                  # 
   ############                                   #     #                  #                  # 
    #         #        ############################     #                  ########E########### 
    #         #                                         #                            #          
    #         #                                         #                            #          
    #####  ####                                         #                            #          
        #  #  ##################E########################                            #          
        #  #                   # #                   ####                            #          
   ######  ##################### #                   #                               #          
   #                             ############        #                               #          
   #                                        ##########                               #          
   #                                        #                                        #          
   #                                        #                                        #          
   #                                        E                                        #          
   #                                        #                                        #          
   ###################################################################################          