############################                                                                    
############################          ##################################                        
##     ####               ##          ##################################                        
##                        ##          ##                              ##                        
##     ####               ##############                              ##                        
###########               E                                           ##                        
###########               ##############                              ##  ######################
         ##               ##          ##                              ##  ######################
         ##               ##          ##                              ##  ##                  ##
         ########  #########          ##                              ##  ##                  ##
  ###############  #########          ##                              ##  ##                  ##
  ###############  ##                 ##                              ##  ##                  ##
  ##       ######  ##                 ##                              ##  ##                  ##
  ##       ######  ##                 ##                              ##  ##                  ##
  ##               ##   ###########################     ################  ##                  ##
  ##       ##########   ###########################     ################  ##                  ##
  ###################   ##           ##############     ##                ##                  ##
   #############        ##           ##############     ##                ##                  ##
   ##         ##        ##           ##############     ##                ########  ############
   ##         ##        ##                              ##                ########  ############
   ##         ##        ##                              ##                      ##  ##          
   ######  #####        ##           #####################                      ##  ##          
   ######  #####        ######## #################################################  ###         
        #  ##           ######## #####               #############################  ###         
   ######  ##################### #############       ##                              ##         
   ######  ##################### #############       ##                              ##         
   ##                                       ###########                              ##         
   ##                                       ###########                              ##         
   ##                                       ##                                       ##         
   ##                                       E                                        ##         
   ##                                       ###########                              ##         
   ####################################################################################         
   ####################################################################################         